{
    "0": {},
    "1": {
        "32": 0,
        "22": 8,
        "10": 8,
        "20": 0,
        "9": 8,
        "11": 7,
        "7": 8,
        "31": 1,
        "1": 2,
        "6": 1,
        "25": 4,
        "27": 1,
        "14": 1,
        "33": 7,
        "12": 2,
        "18": 7,
        "24": 8,
        "2": 8,
        "17": 2,
        "15": 5,
        "16": 8,
        "19": 2,
        "4": 2,
        "3": 2,
        "34": 8,
        "35": 2,
        "26": 8,
        "23": 8,
        "21": 8,
        "29": 6,
        "8": 6,
        "28": 7,
        "30": 7,
        "0": 8,
        "13": 8,
        "5": 8
    },
    "2": {
        "22": 0,
        "43": 0,
        "42": 24,
        "20": 1,
        "25": 31,
        "45": 1,
        "32": 1,
        "55": 31,
        "26": 1,
        "10": 2,
        "11": 16,
        "21": 3,
        "2": 18,
        "13": 10,
        "57": 6,
        "0": 6,
        "39": 7,
        "52": 29,
        "12": 9,
        "51": 19,
        "16": 10,
        "38": 11,
        "4": 11,
        "47": 12,
        "27": 13,
        "58": 22,
        "41": 14,
        "23": 15,
        "30": 24,
        "24": 16,
        "5": 16,
        "33": 22,
        "9": 18,
        "6": 18,
        "50": 18,
        "14": 21,
        "49": 33,
        "7": 22,
        "34": 22,
        "61": 23,
        "44": 23,
        "62": 23,
        "48": 24,
        "59": 24,
        "15": 24,
        "31": 25,
        "1": 25,
        "18": 25,
        "56": 34,
        "40": 26,
        "17": 27,
        "29": 28,
        "28": 28,
        "35": 30,
        "19": 31,
        "60": 31,
        "54": 31,
        "8": 32,
        "53": 33,
        "37": 33,
        "36": 33,
        "3": 34,
        "46": 35
    },
    "3": {
        "46": 52,
        "25": 1,
        "38": 1,
        "75": 1,
        "56": 2,
        "79": 33,
        "70": 2,
        "3": 2,
        "81": 2,
        "44": 3,
        "59": 4,
        "27": 5,
        "61": 5,
        "22": 5,
        "63": 6,
        "50": 7,
        "17": 8,
        "78": 9,
        "32": 10,
        "41": 11,
        "52": 11,
        "73": 12,
        "47": 13,
        "48": 13,
        "13": 14,
        "71": 15,
        "0": 16,
        "40": 17,
        "33": 18,
        "68": 55,
        "42": 20,
        "18": 20,
        "43": 21,
        "1": 22,
        "12": 22,
        "29": 23,
        "65": 49,
        "64": 25,
        "60": 25,
        "58": 25,
        "36": 26,
        "45": 27,
        "14": 27,
        "57": 28,
        "21": 29,
        "76": 30,
        "69": 30,
        "62": 31,
        "16": 32,
        "28": 33,
        "26": 34,
        "55": 35,
        "80": 36,
        "72": 37,
        "5": 48,
        "67": 38,
        "51": 39,
        "4": 40,
        "2": 41,
        "8": 42,
        "37": 59,
        "31": 43,
        "49": 53,
        "20": 44,
        "9": 45,
        "30": 46,
        "74": 47,
        "53": 49,
        "54": 50,
        "10": 51,
        "24": 51,
        "15": 52,
        "39": 54,
        "82": 55,
        "66": 55,
        "19": 56,
        "7": 56,
        "34": 57,
        "23": 57,
        "35": 58,
        "6": 58,
        "11": 60,
        "77": 62
    },
    "4": {
        "41": 0,
        "1": 1,
        "27": 1,
        "98": 2,
        "78": 3,
        "83": 4,
        "12": 5,
        "22": 5,
        "37": 5,
        "93": 6,
        "74": 7,
        "42": 8,
        "29": 9,
        "44": 10,
        "15": 11,
        "67": 12,
        "8": 13,
        "75": 14,
        "40": 15,
        "31": 16,
        "7": 17,
        "72": 18,
        "39": 19,
        "92": 20,
        "9": 21,
        "79": 22,
        "47": 23,
        "82": 24,
        "32": 25,
        "77": 26,
        "35": 27,
        "26": 28,
        "48": 29,
        "69": 30,
        "46": 31,
        "18": 32,
        "91": 33,
        "5": 34,
        "11": 35,
        "87": 35,
        "86": 36,
        "14": 37,
        "56": 37,
        "76": 38,
        "58": 39,
        "45": 40,
        "23": 41,
        "4": 42,
        "63": 43,
        "64": 44,
        "54": 45,
        "13": 46,
        "38": 46,
        "10": 47,
        "71": 47,
        "97": 48,
        "65": 49,
        "80": 49,
        "61": 50,
        "99": 51,
        "81": 52,
        "88": 53,
        "70": 54,
        "62": 55,
        "33": 56,
        "53": 57,
        "57": 58,
        "89": 59,
        "55": 60,
        "50": 61,
        "28": 62,
        "43": 63,
        "16": 64,
        "17": 65,
        "30": 65,
        "68": 66,
        "95": 67,
        "96": 67,
        "2": 68,
        "34": 68,
        "6": 69,
        "59": 70,
        "25": 71,
        "73": 72,
        "21": 73,
        "94": 74,
        "90": 75,
        "3": 76,
        "66": 76,
        "19": 77,
        "24": 77,
        "0": 78,
        "20": 79,
        "36": 79,
        "49": 79,
        "51": 79,
        "52": 79,
        "85": 80,
        "84": 81,
        "60": 82
    }
}